Move tab to a new group: Ctrl + K, Ctrl + Up
Create a new group: Ctrl + K, Ctrl + Shift + Up
Close group: Ctrl + K, Ctrl + Down
Focus to next group: Ctrl + K, Ctrl + Right
Focus to previous group: Ctrl + K, Ctrl + Left
Move tab to next group: Ctrl + K, Ctrl + Shift + Right
Move tab to previous group: Ctrl + K, Ctrl + Shift + Left
Focus to group #: Ctrl + (1,2,3,4,5,6,7,8,9)
Focus to sidebar: Ctrl + 0
Move tab to group #: Ctrl + Shift + (1,2,3,4,5,6,7,8,9)
Insert line before: Ctrl + Shift + Return
Insert line after: Ctrl + Return
Go to anything: Ctrl + P
Go to symbol: Ctrl + R
Go to line number: Ctrl + G
Go to word: Ctrl + ;
List copied items from clipboard: Ctrl + K, Ctrl + V
Delete to beginning of line: Ctrl + Shift + backspace
Delete to end of line: Ctrl + K, Ctrl + K
Delete whole line: Ctrl + Shift + K
Soft undo: Ctrl + U
Soft redo: Ctrl + Shift + U
Copy line: Ctrl + C
Cut line: Ctrl + X
Soft undo/redo tracks soft actions (e.g. cursor position, highlights)
Convert line to uppercase: Ctrl + K, Ctrl + U
Convert line to lowercase: Ctrl + K, Ctrl + L
Join lines: Ctrl + Shift + J
Move line up: Ctrl + Shift + Up
Move line down: Ctrl + Shift + Down
Sort lines: F9
Sort lines (case sensitive): Ctrl + f9
Duplicate line: Ctrl + Shift + D
Indent line: Ctrl + ]
Unindent line: Ctrl + [
Toggle comments: Ctrl + /
Close HTML tag: Alt + .
Wrap lines at ruler: Alt + Q
Move left character to the right of cursor: Ctrl + T
Select occurrence of word under cursor: Ctrl + D
Skip selected word occurrence: Ctrl + K, Ctrl + D
Exact word match: Ctrl + D
Search symbol (in project): Ctrl + Shift + R
Search symbol (in view): Ctrl + R
Go to definition: F12
Go to beginning of line: Home
Go to beginning of file: Ctrl + Home
Go to end of line: End
Go to end of file: Ctrl + End
Go to matching bracket: Ctrl + M
Highlight up to matching brackets: Ctrl + Shift + M
Cursor position (backward): Alt + -
Cursor position (forward): Alt + Shift + -
Fold code: Ctrl + Shift + [
Unfold code: Ctrl + Shift + ]
Open Python console: Ctrl + `
Open command palette: Ctrl + Shift + P
Open context menu: Shift + F10
Show scope: Ctrl + Alt + Shift + P
