Move tab to a new group: [PRIMARY] + K, [PRIMARY] + Up
Create a new group: [PRIMARY] + K, [PRIMARY] + Shift + Up
Close group: [PRIMARY] + K, [PRIMARY] + Down
Focus to next group: [PRIMARY] + K, [PRIMARY] + Right
Focus to previous group: [PRIMARY] + K, [PRIMARY] + Left
Move tab to next group: [PRIMARY] + K, [PRIMARY] + Shift + Right
Move tab to previous group: [PRIMARY] + K, [PRIMARY] + Shift + Left
Focus to group #: [PRIMARY] + (1,2,3,4,5,6,7,8,9)
Focus to sidebar: [PRIMARY] + 0
Move tab to group #: [PRIMARY] + Shift + (1,2,3,4,5,6,7,8,9)
Insert line before: [PRIMARY] + Shift + Return
Insert line after: [PRIMARY] + Return
Goto anything: [PRIMARY] + P
Goto symbol: [PRIMARY] + R
Goto line number: [PRIMARY] + G
List copied items from clipboard: [PRIMARY] + K, [PRIMARY] + V
Delete to beginning of line: [PRIMARY] + Shift + backspace
Delete to end of line: [PRIMARY] + K, [PRIMARY] + K
Delete whole line: [PRIMARY] + Shift + K
Soft undo: [PRIMARY] + U
Soft redo: [PRIMARY] + Shift + U
Soft undo/redo tracks soft actions (e.g. cursor position, highlights)
Convert line to uppercase: [PRIMARY] + K, [PRIMARY] + U
Convert line to lowercase: [PRIMARY] + K, [PRIMARY] + L
Join lines: [PRIMARY] + Shift + J
Move line up: [PRIMARY] + Shift + Up
Move line down: [PRIMARY] + Shift + Down
Sort lines: F9
Sort lines (case sensitive): [PRIMARY] + f9
Duplicate line: [PRIMARY] + Shift + D
Indent line: [PRIMARY] + ]
Unindent line: [PRIMARY] + [
Toggle comments: [PRIMARY] + /
Close HTML tag: [ALT] + .
Wrap lines at ruler: [ALT] + Q
Move left character to the right of cursor: [PRIMARY] + T
Select occurrence of word under cursor: [PRIMARY] + D
Skip selected word occurrence: [PRIMARY] + K, [PRIMARY] + D
Exact word match: [PRIMARY] + D
Search symbol (in project): [PRIMARY] + Shift + R
Search symbol (in view): [PRIMARY] + R
Go to definition: F12
Go to beginning of line: Home
Go to beginning of file: [PRIMARY] + Home
Go to end of line: End
Go to end of file: [PRIMARY] + End
Go to matching bracket: [PRIMARY] + M
Highlight up to matching brackets: [PRIMARY] + Shift + M
Cursor position (backward): [ALT] + -
Cursor position (forward): [ALT] + Shift + -
Fold code: [PRIMARY] + Shift + [
Unfold code: [PRIMARY] + Shift + ]
Open Python console: [PRIMARY] + `
Open command palette: [PRIMARY] + Shift + P
Open context menu: Shift + F10
